Index,Type,Eye,Start_time,End_time,Duration,Avg_x,Avg_y,Angle
0,EFIX,R,333976098,333976193,95,1228.1,706.9,5106
1,EFIX,R,333975752,333976046,294,517.3,471.5,4888
2,EFIX,R,333975447,333975685,238,1276.7,712.5,5342
3,EFIX,R,333975234,333975426,192,1312.2,700.5,5243
4,EFIX,R,333974940,333975184,244,674.2,438.0,5087
5,EFIX,R,333974646,333974878,232,1273.8,714.7,5255
6,EFIX,R,333974456,333974626,170,1305.1,748.7,5225
7,EFIX,R,333974233,333974404,171,2011.7,247.4,4836
8,EFIX,R,333973409,333974165,756,2332.5,1102.5,4713
9,EFIX,R,333972822,333973144,322,1256.9,725.9,4529
10,EFIX,R,333972141,333972785,644,1055.0,919.6,4360
11,EFIX,R,333971675,333972101,426,1503.3,830.2,4295
12,EFIX,R,333971450,333971622,172,1079.4,902.5,4540
13,EFIX,R,333971165,333971412,247,1454.3,942.2,4894
14,EFIX,R,333970963,333971128,165,1268.4,1345.6,4988
15,EFIX,R,333970187,333970953,766,1263.8,1335.7,4719
16,EFIX,R,333969873,333970176,303,1259.7,1366.1,4352
17,EFIX,R,333969618,333969864,246,1279.3,1358.2,4136
18,EFIX,R,333969377,333969560,183,567.9,622.8,3686
19,EFIX,R,333969183,333969360,177,599.7,602.6,3915
20,EFIX,R,333968316,333969125,809,1261.9,705.6,5190
21,EFIX,R,333967975,333968309,334,1280.1,716.3,5284
22,EFIX,R,333967709,333967955,246,1305.5,690.6,5313
23,EFIX,R,333967250,333967623,373,2384.2,1687.5,4486
24,EFIX,R,333966385,333967141,756,1986.6,669.7,5081
25,EFIX,R,333965962,333966255,293,1501.5,1278.8,5170
26,EFIX,R,333965334,333965656,322,1263.0,714.7,4730
27,EFIX,R,333964880,333965300,420,1192.6,868.9,4524
28,EFIX,R,333964634,333964843,209,1445.7,1128.2,4346
29,EFIX,R,333964331,333964586,255,1518.6,861.2,4291
30,EFIX,R,333964019,333964277,258,1092.9,961.0,4553
31,EFIX,R,333963730,333963991,261,1037.9,872.6,4564
32,EFIX,R,333963460,333963699,239,1247.7,914.0,4951
33,EFIX,R,333962036,333963422,1386,1258.4,1350.9,4614
34,EFIX,R,333961637,333961977,340,1970.0,568.3,3918
35,EFIX,R,333961477,333961614,137,1937.5,556.8,3995
36,EFIX,R,333961163,333961425,262,1267.7,1374.4,3874
37,EFIX,R,333960969,333961143,174,1259.1,1339.4,3678
38,EFIX,R,333960798,333960931,133,1204.7,926.5,4504
39,EFIX,R,333960572,333960749,177,1245.5,631.0,5208
40,EFIX,R,333960220,333960512,292,374.9,387.7,5082
41,EFIX,R,333959942,333960141,199,1274.6,711.9,5268
42,EFIX,R,333959732,333959923,191,1314.9,735.5,5144
43,EFIX,R,333959462,333959681,219,518.7,361.1,4913
44,EFIX,R,333958809,333959382,573,1268.5,710.8,5156
45,EFIX,R,333958556,333958795,239,1302.0,701.8,5232
46,EFIX,R,333958362,333958513,151,1338.8,1102.7,5309
47,EFIX,R,333957625,333958272,647,2199.9,557.9,4683
48,EFIX,R,333957090,333957375,285,1276.2,722.1,5099
49,EFIX,R,333956853,333957070,217,1271.4,681.7,4848
50,EFIX,R,333956487,333956812,325,1677.2,136.5,4497
51,EFIX,R,333956169,333956455,286,1782.5,276.3,4482
52,EFIX,R,333955922,333956123,201,1392.6,653.8,4365
53,EFIX,R,333955547,333955863,316,1122.4,1403.6,3984
54,EFIX,R,333955418,333955508,90,1088.7,1157.5,4019
55,EFIX,R,333955351,333955401,50,1093.3,1130.4,4349
56,EFIX,R,333954934,333955113,179,1946.7,592.9,4689
57,EFIX,R,333953782,333954926,1144,1958.7,577.3,4250
58,EFIX,R,333953638,333953761,123,1921.1,562.1,4087
59,EFIX,R,333953267,333953571,304,570.5,605.4,4112
60,EFIX,R,333953073,333953259,186,571.0,621.6,3738
61,EFIX,R,333952899,333953028,129,909.5,824.4,3576
62,EFIX,R,333952584,333952866,282,1016.9,977.4,3499
63,EFIX,R,333952390,333952551,161,1299.4,1064.6,3876
64,EFIX,R,333952120,333952379,259,1313.4,1038.1,3618
65,EFIX,R,333951924,333952081,157,1254.8,1368.1,3406
66,EFIX,R,333951642,333951888,246,1381.3,1031.6,3455
67,EFIX,R,333951449,333951617,168,1288.8,1003.8,4049
68,EFIX,R,333951264,333951401,137,1284.2,730.9,5109
69,EFIX,R,333950607,333951255,648,1278.8,709.0,5306
70,EFIX,R,333950375,333950587,212,1340.0,721.2,5413
71,EFIX,R,333950062,333950319,257,703.9,302.7,5269
72,EFIX,R,333949539,333949795,256,330.4,722.8,5374
73,EFIX,R,333948851,333949463,612,1269.9,714.6,5203
74,EFIX,R,333948440,333948842,402,1285.8,708.8,5287
75,EFIX,R,333948113,333948433,320,1290.3,721.5,5360
76,EFIX,R,333947691,333948042,351,1289.9,708.5,5413
77,EFIX,R,333947522,333947667,145,1220.2,653.6,5345
78,EFIX,R,333947231,333947463,232,1213.2,116.0,5218
79,EFIX,R,333946916,333947145,229,2160.7,493.4,4875
80,EFIX,R,333946347,333946752,405,1314.2,684.0,5411
81,EFIX,R,333945964,333946315,351,1381.6,766.9,5477
82,EFIX,R,333945350,333945896,546,1859.3,1387.5,5256
83,EFIX,R,333943971,333945272,1301,1355.7,769.7,5304
84,EFIX,R,333943805,333943906,101,2064.3,1722.8,4436
85,EFIX,R,333941128,333941412,284,1285.2,707.4,4898
86,EFIX,R,333940655,333941081,426,580.5,611.2,4380
87,EFIX,R,333939853,333940644,791,579.0,633.5,4190
88,EFIX,R,333939580,333939815,235,584.8,341.2,3977
89,EFIX,R,333939291,333939550,259,401.8,168.3,4003
90,EFIX,R,333939092,333939277,185,405.1,191.2,3821
91,EFIX,R,333938901,333939060,159,717.4,209.0,3669
92,EFIX,R,333938696,333938871,175,791.5,335.8,3779
93,EFIX,R,333938502,333938649,147,1302.0,962.8,4329
94,EFIX,R,333938291,333938471,180,1293.2,702.4,5058
95,EFIX,R,333937929,333938240,311,746.2,388.1,4732
96,EFIX,R,333937431,333937878,447,1257.5,704.2,5083
97,EFIX,R,333937084,333937423,339,1260.7,675.4,5128
98,EFIX,R,333936701,333937035,334,587.5,555.8,4755
99,EFIX,R,333936451,333936633,182,1256.6,693.9,4205
100,EFIX,R,333936165,333936426,261,1192.0,687.9,3649
101,EFIX,R,333935856,333936106,250,1800.5,148.7,4230
102,EFIX,R,333935224,333935824,600,1686.8,52.4,4585
103,EFIX,R,333934731,333935146,415,2498.3,493.8,4309
104,EFIX,R,333934066,333934671,605,2463.1,1145.5,4399
105,EFIX,R,333933350,333934010,660,2264.0,503.1,4322
106,EFIX,R,333932737,333933244,507,1638.0,877.3,4853
107,EFIX,R,333932409,333932687,278,1483.2,1434.1,4482
108,EFIX,R,333932079,333932359,280,1564.9,842.5,4297
109,EFIX,R,333931806,333932039,233,1351.3,796.5,4358
110,EFIX,R,333931532,333931772,240,1242.6,794.4,4135
111,EFIX,R,333931282,333931465,183,1542.2,-4.7,3737
112,EFIX,R,333930847,333931211,364,1156.8,730.0,3939
113,EFIX,R,333930645,333930819,174,1273.5,613.2,3632
114,EFIX,R,333930459,333930611,152,1123.5,737.7,4223
115,EFIX,R,333928414,333929085,671,1259.2,710.2,3957
116,EFIX,R,333928175,333928390,215,1237.0,792.5,3453
117,EFIX,R,333927882,333928149,267,1250.7,719.1,3754
118,EFIX,R,333927613,333927868,255,1238.8,682.6,3550
119,EFIX,R,333927183,333927578,395,1073.1,622.5,3451
120,EFIX,R,333926950,333927152,202,1246.4,637.2,3718
121,EFIX,R,333926668,333926927,259,1221.0,608.8,4040
122,EFIX,R,333926441,333926646,205,1162.8,610.0,4147
123,EFIX,R,333926238,333926396,158,1468.3,628.5,3951
124,EFIX,R,333925980,333926198,218,1060.3,623.2,3442
125,EFIX,R,333925769,333925957,188,1069.7,668.8,2919
126,EFIX,R,333925518,333925713,195,1082.1,1483.8,3654
127,EFIX,R,333924938,333925439,501,1458.3,586.9,3459
128,EFIX,R,333924656,333924888,232,1688.2,192.2,3669
129,EFIX,R,333923898,333924593,695,1567.8,702.2,3999
130,EFIX,R,333923486,333923871,385,1490.1,625.9,4083
131,EFIX,R,333923327,333923455,128,1321.8,703.9,5244
132,EFIX,R,333922396,333923130,734,2734.4,1393.4,4210
133,EFIX,R,333921760,333922337,577,2419.1,905.1,4508
134,EFIX,R,333921255,333921693,438,2518.6,340.6,3817
135,EFIX,R,333920521,333921210,689,2248.8,478.1,3870
136,EFIX,R,333919966,333920453,487,1751.4,691.9,3357
137,EFIX,R,333919561,333919900,339,1949.8,1466.6,2748
138,EFIX,R,333919160,333919494,334,1153.3,1368.0,2936
139,EFIX,R,333918839,333919126,287,1012.1,1391.3,3168
140,EFIX,R,333918420,333918771,351,1325.0,617.0,3293
141,EFIX,R,333918155,333918366,211,1276.5,1475.7,3498
142,EFIX,R,333917558,333918090,532,1222.5,569.0,3781
143,EFIX,R,333917252,333917523,271,1014.4,593.6,3755
144,EFIX,R,333917018,333917223,205,1100.5,682.9,3854
145,EFIX,R,333916736,333917001,265,1134.1,685.1,3675
146,EFIX,R,333916565,333916710,145,1200.4,578.8,3202
147,EFIX,R,333916387,333916539,152,1183.5,660.1,3211
148,EFIX,R,333916084,333916324,240,85.7,168.9,2989
149,EFIX,R,333915933,333915975,42,-180.6,211.8,3229
150,EFIX,R,333915832,333915875,43,-174.0,232.5,3405
151,EFIX,R,333915589,333915621,32,263.1,643.1,4056
152,EFIX,R,333915387,333915556,169,283.3,632.5,4495
153,EFIX,R,333914754,333915179,425,1395.4,59.2,4143
154,EFIX,R,333914389,333914690,301,1243.9,687.4,3420
155,EFIX,R,333914101,333914358,257,1403.5,681.0,3078
156,EFIX,R,333913795,333914086,291,1410.0,712.0,3244
157,EFIX,R,333913537,333913768,231,1492.2,712.5,3298
158,EFIX,R,333913304,333913517,213,1551.1,707.8,3135
159,EFIX,R,333912680,333913275,595,1416.1,691.5,3359
160,EFIX,R,333912463,333912636,173,1007.0,643.2,3147
161,EFIX,R,333912139,333912426,287,1371.2,671.3,3232
162,EFIX,R,333911893,333912108,215,1459.4,621.3,3455
163,EFIX,R,333911608,333911873,265,1496.2,650.6,3808
164,EFIX,R,333911429,333911577,148,1449.5,860.9,3682
165,EFIX,R,333911087,333911399,312,1281.5,842.0,3398
166,EFIX,R,333910830,333911059,229,1142.6,803.7,3212
167,EFIX,R,333910562,333910807,245,1213.8,785.5,3225
168,EFIX,R,333910226,333910543,317,1239.0,758.4,3074
169,EFIX,R,333909632,333910201,569,1153.5,726.0,3197
170,EFIX,R,333909354,333909615,261,1169.2,766.5,3879
171,EFIX,R,333908417,333909326,909,1276.3,710.1,5340
172,EFIX,R,333908118,333908402,284,1271.8,698.5,5411
173,EFIX,R,333907988,333908055,67,473.2,397.4,5132
174,EFIX,R,333907763,333907941,178,458.7,381.5,5137
175,EFIX,R,333907385,333907682,297,1263.6,718.6,5151
176,EFIX,R,333907195,333907364,169,1333.5,710.0,5479
177,EFIX,R,333906953,333907131,178,2171.3,550.1,5089
178,EFIX,R,333906119,333906927,808,2244.2,426.1,4948
179,EFIX,R,333905716,333906079,363,2187.6,233.9,4828
180,EFIX,R,333904943,333905659,716,2424.8,691.3,4741
181,EFIX,R,333904470,333904824,354,1373.5,715.7,5181
182,EFIX,R,333903787,333904435,648,1265.8,717.1,4931
183,EFIX,R,333903480,333903778,298,1287.2,703.3,5159
184,EFIX,R,333902984,333903468,484,1291.1,711.9,5447
185,EFIX,R,333902668,333902951,283,1218.3,677.0,5780
186,EFIX,R,333902222,333902275,53,113.9,1800.1,5242
187,EFIX,R,333901986,333902095,109,118.2,1805.6,5131
188,EFIX,R,333901708,333901962,254,114.6,1781.4,5136
189,EFIX,R,333901553,333901698,145,116.4,1781.7,5040
190,EFIX,R,333901438,333901507,69,422.6,1546.8,5209
191,EFIX,R,333901241,333901423,182,414.4,1538.6,5064
192,EFIX,R,333901066,333901117,51,391.8,1563.1,5099
193,EFIX,R,333900682,333900957,275,1030.6,712.7,5205
194,EFIX,R,333900256,333900597,341,1942.5,148.5,4952
195,EFIX,R,333899726,333900150,424,1330.8,722.5,5374
196,EFIX,R,333899522,333899678,156,635.0,725.5,5575
197,EFIX,R,333898829,333899289,460,1310.3,707.2,5224
198,EFIX,R,333897561,333898780,1219,1954.6,587.1,4257
199,EFIX,R,333897228,333897509,281,1336.6,935.2,4547
200,EFIX,R,333896532,333897188,656,1277.5,1347.0,4753
201,EFIX,R,333896394,333896508,114,1302.9,1289.5,4459
202,EFIX,R,333896059,333896340,281,585.6,638.4,4118
203,EFIX,R,333895884,333896027,143,756.8,328.2,4407
204,EFIX,R,333895666,333895833,167,1591.6,50.5,5098
205,EFIX,R,333894700,333895597,897,1747.6,890.6,5108
206,EFIX,R,333894039,333894647,608,1269.6,731.0,4861
207,EFIX,R,333893816,333894029,213,1274.4,729.8,4394
208,EFIX,R,333893503,333893775,272,1784.6,1017.5,3592
209,EFIX,R,333892793,333893449,656,1066.4,1456.8,4508
210,EFIX,R,333892315,333892737,422,1295.0,721.8,5150
211,EFIX,R,333891813,333892296,483,1255.0,723.6,5166
212,EFIX,R,333890875,333891797,922,1296.9,702.8,5213
213,EFIX,R,333890578,333890862,284,1288.5,717.1,5400
214,EFIX,R,333890255,333890511,256,2154.6,1600.9,4732
215,EFIX,R,333889397,333890194,797,2191.4,845.6,5185
216,EFIX,R,333888242,333889354,1112,2165.4,612.8,5073
217,EFIX,R,333887329,333888179,850,1842.9,298.3,5053
218,EFIX,R,333886657,333887093,436,1279.2,726.9,5274
219,EFIX,R,333885536,333886610,1074,1268.1,1335.7,4631
220,EFIX,R,333885362,333885520,158,1266.3,1378.2,4432
221,EFIX,R,333885014,333885298,284,1961.7,562.0,3914
222,EFIX,R,333884852,333884997,145,1948.1,536.8,3821
223,EFIX,R,333884421,333884797,376,1263.5,1380.4,3562
224,EFIX,R,333884291,333884389,98,1278.9,1159.7,4240
225,EFIX,R,333884078,333884240,162,1273.3,701.8,5235
226,EFIX,R,333883772,333884027,255,683.3,343.4,5088
227,EFIX,R,333883441,333883709,268,181.9,1124.2,5101
228,EFIX,R,333882988,333883275,287,1266.6,709.8,5100
229,EFIX,R,333882662,333882976,314,1275.9,711.8,5046
230,EFIX,R,333882284,333882610,326,1986.2,368.9,4751
231,EFIX,R,333881436,333882222,786,2504.2,795.8,4706
232,EFIX,R,333880891,333881354,463,2254.1,1136.4,4952
233,EFIX,R,333880274,333880601,327,1304.6,708.8,4937
234,EFIX,R,333879991,333880228,237,1689.1,378.1,4375
235,EFIX,R,333879615,333879960,345,1770.6,309.1,4289
236,EFIX,R,333879298,333879590,292,1843.2,269.7,4318
237,EFIX,R,333879096,333879263,167,1854.0,100.3,4200
238,EFIX,R,333878859,333879063,204,1667.1,142.5,4623
239,EFIX,R,333878562,333878826,264,1841.5,258.9,4645
240,EFIX,R,333877588,333878524,936,1963.8,573.8,4067
241,EFIX,R,333877258,333877576,318,1964.4,594.8,3882
242,EFIX,R,333877008,333877244,236,1972.4,559.2,4096
243,EFIX,R,333876003,333876959,956,2266.2,730.6,4372
244,EFIX,R,333875586,333875913,327,1268.7,688.6,3679
245,EFIX,R,333875358,333875569,211,1238.2,632.4,2868
246,EFIX,R,333874987,333875271,284,245.3,1603.2,2756
247,EFIX,R,333874795,333874945,150,-196.7,1457.5,3004
248,EFIX,R,333874514,333874760,246,-151.0,1458.2,3868
249,EFIX,R,333874187,333874395,208,1268.6,705.4,5073
250,EFIX,R,333873942,333874153,211,1188.9,698.6,5113
251,EFIX,R,333873567,333873865,298,-12.4,1663.9,4785
252,EFIX,R,333873168,333873493,325,129.4,638.9,4948
253,EFIX,R,333872323,333873048,725,1261.6,708.8,4766
254,EFIX,R,333871404,333872308,904,1262.6,699.6,4748
255,EFIX,R,333871110,333871374,264,1273.3,718.6,4130
256,EFIX,R,333870888,333871056,168,1797.1,371.1,4464
257,EFIX,R,333870064,333870819,755,1273.8,715.8,4742
258,EFIX,R,333869833,333870054,221,1241.1,713.7,4261
259,EFIX,R,333869563,333869811,248,1227.1,650.9,3685
260,EFIX,R,333869099,333869489,390,535.6,1581.7,4370
261,EFIX,R,333868742,333869041,299,436.8,1939.7,4203
262,EFIX,R,333868689,333868731,42,428.8,1948.4,3831
263,EFIX,R,333868126,333868632,506,59.3,1633.7,3389
264,EFIX,R,333867597,333868032,435,154.7,674.4,4496
265,EFIX,R,333866955,333867348,393,1265.1,722.0,5062
266,EFIX,R,333865816,333866907,1091,1258.1,1357.2,4276
267,EFIX,R,333865666,333865791,125,1240.3,1302.2,3694
268,EFIX,R,333865405,333865609,204,1959.4,570.0,3579
269,EFIX,R,333864945,333865371,426,1752.2,402.0,4834
270,EFIX,R,333864239,333864895,656,2203.3,765.0,4938
271,EFIX,R,333862927,333864219,1292,2285.0,736.0,4608
272,EFIX,R,333862362,333862657,295,1257.3,709.1,4114
273,EFIX,R,333862076,333862331,255,1093.7,608.1,3736
274,EFIX,R,333861827,333862055,228,1038.4,662.6,3760
275,EFIX,R,333861578,333861798,220,1030.2,774.8,3884
276,EFIX,R,333861262,333861548,286,1070.5,669.1,3845
277,EFIX,R,333860987,333861240,253,1095.1,626.1,4021
278,EFIX,R,333860752,333860965,213,1038.6,692.8,4183
279,EFIX,R,333860470,333860728,258,1081.7,642.9,4229
280,EFIX,R,333860219,333860437,218,1198.1,803.5,4002
281,EFIX,R,333859631,333860186,555,1077.5,637.9,3953
282,EFIX,R,333859014,333859624,610,1102.3,642.5,4150
283,EFIX,R,333858723,333858986,263,960.6,586.7,3884
284,EFIX,R,333858193,333858700,507,1003.6,592.0,3835
285,EFIX,R,333857998,333858169,171,1077.0,648.4,3939
286,EFIX,R,333857721,333857982,261,1056.2,640.6,3862
287,EFIX,R,333857540,333857679,139,1478.3,615.3,3788
288,EFIX,R,333857297,333857515,218,1448.4,698.9,4032
289,EFIX,R,333856853,333857240,387,2326.0,594.9,3431
290,EFIX,R,333856405,333856657,252,1828.8,157.1,3054
291,EFIX,R,333856030,333856369,339,1752.6,285.4,3035
292,EFIX,R,333855620,333855959,339,1695.5,1559.8,3764
293,EFIX,R,333855349,333855532,183,1266.4,720.9,4352
294,EFIX,R,333854690,333855317,627,1023.9,603.3,4112
295,EFIX,R,333854292,333854662,370,1102.0,692.8,4376
296,EFIX,R,333854107,333854263,156,1031.8,620.8,4410
297,EFIX,R,333853884,333854082,198,1102.8,676.4,4350
298,EFIX,R,333853619,333853856,237,1214.2,618.9,4288
299,EFIX,R,333853318,333853584,266,1502.6,777.6,4568
300,EFIX,R,333852962,333853284,322,1309.8,601.6,5022
301,EFIX,R,333852137,333852896,759,2401.9,489.3,4349
302,EFIX,R,333851602,333851930,328,1659.3,-31.9,4333
303,EFIX,R,333850995,333851567,572,1876.2,-30.7,3742
304,EFIX,R,333850719,333850911,192,1114.0,672.9,4194
305,EFIX,R,333850546,333850690,144,1026.6,592.0,4095
306,EFIX,R,333850298,333850518,220,1190.4,587.1,4518
307,EFIX,R,333850085,333850271,186,1325.5,588.0,5627
308,EFIX,R,333848500,333848695,195,1292.2,717.1,5190
309,EFIX,R,333848330,333848464,134,1088.7,684.3,4998
310,EFIX,R,333847387,333847661,274,62.6,1004.2,4293
311,EFIX,R,333846567,333847306,739,1271.0,1488.4,4036
312,EFIX,R,333846105,333846511,406,1413.2,687.7,4700
313,EFIX,R,333845749,333846072,323,1241.5,760.0,4733
314,EFIX,R,333845451,333845708,257,972.3,610.5,4702
315,EFIX,R,333845127,333845416,289,1175.3,816.7,4843
316,EFIX,R,333844822,333845087,265,1504.5,714.2,4568
317,EFIX,R,333844526,333844775,249,1482.4,1410.5,4029
318,EFIX,R,333844164,333844472,308,1418.5,656.3,4191
319,EFIX,R,333843852,333844131,279,1225.2,818.0,4395
320,EFIX,R,333843634,333843809,175,1379.6,680.4,4091
321,EFIX,R,333843309,333843599,290,1186.6,797.7,4068
322,EFIX,R,333842788,333843273,485,1256.8,716.3,5474
323,EFIX,R,333842499,333842744,245,1756.0,1035.3,5543
324,EFIX,R,333842064,333842456,392,1921.8,801.4,5355
325,EFIX,R,333841376,333841998,622,1526.6,1348.8,5219
326,EFIX,R,333840731,333841325,594,1405.1,793.5,5024
327,EFIX,R,333840341,333840699,358,1308.1,818.6,4920
328,EFIX,R,333840107,333840307,200,1410.8,663.5,4868
329,EFIX,R,333839703,333840067,364,1114.7,892.4,4809
330,EFIX,R,333839498,333839676,178,1199.3,804.6,4796
331,EFIX,R,333839122,333839479,357,1231.2,815.3,5033
332,EFIX,R,333838764,333839093,329,1336.7,781.1,5245
333,EFIX,R,333838429,333838715,286,1610.2,1390.3,5024
334,EFIX,R,333838141,333838378,237,1567.9,845.9,5019
335,EFIX,R,333837807,333838102,295,1524.9,998.8,4752
336,EFIX,R,333837262,333837759,497,1172.2,838.5,4733
337,EFIX,R,333837092,333837203,111,1062.9,1562.0,4407
338,EFIX,R,333836866,333837032,166,1319.5,819.6,4330
339,EFIX,R,333836504,333836849,345,1342.3,828.7,3814
340,EFIX,R,333836273,333836465,192,1445.9,639.5,3773
341,EFIX,R,333835324,333836242,918,1271.1,722.9,5256
342,EFIX,R,333834876,333835314,438,1292.8,708.4,5336
343,EFIX,R,333834779,333834828,49,1294.9,703.9,5268
344,EFIX,R,333834026,333834766,740,1281.1,708.6,5371
345,EFIX,R,333833688,333833962,274,815.9,177.6,5179
346,EFIX,R,333833405,333833624,219,131.2,610.8,5368
347,EFIX,R,333833301,333833395,94,135.1,620.9,5297
348,EFIX,R,333832323,333833148,825,1286.8,711.0,5150
349,EFIX,R,333831710,333832274,564,427.9,827.1,5216
350,EFIX,R,333831425,333831631,206,1219.8,716.7,4957
351,EFIX,R,333830001,333831403,1402,1269.0,721.0,4841
352,EFIX,R,333829719,333829990,271,1275.4,703.8,4373
353,EFIX,R,333829290,333829661,371,1915.0,613.1,3222
354,EFIX,R,333828953,333829229,276,1823.7,178.0,3055
355,EFIX,R,333828588,333828923,335,2014.9,201.4,4096
356,EFIX,R,333828206,333828521,315,1731.1,154.5,5023
357,EFIX,R,333828059,333828131,72,2588.8,586.5,4695
358,EFIX,R,333827764,333828048,284,2586.8,583.8,4639
359,EFIX,R,333826723,333827717,994,2425.2,886.7,4952
360,EFIX,R,333826329,333826587,258,2166.0,1653.3,4528
361,EFIX,R,333825578,333825854,276,1286.4,706.9,5171
362,EFIX,R,333824453,333825521,1068,1958.0,590.8,4529
363,EFIX,R,333824296,333824429,133,1927.9,649.7,4545
364,EFIX,R,333824029,333824236,207,949.6,966.9,4565
365,EFIX,R,333823738,333823982,244,579.2,640.0,4371
366,EFIX,R,333823548,333823697,149,1086.1,917.8,4831
367,EFIX,R,333823195,333823502,307,1268.6,1350.6,4756
368,EFIX,R,333823041,333823173,132,1318.5,1361.4,4493
369,EFIX,R,333822597,333822988,391,1955.3,579.0,3808
370,EFIX,R,333822400,333822566,166,1865.3,372.4,4395
371,EFIX,R,333821254,333822344,1090,1863.4,1400.1,5535
372,EFIX,R,333820636,333821226,590,1953.9,1405.0,5367
373,EFIX,R,333820261,333820580,319,1643.6,961.4,5555
374,EFIX,R,333819762,333820214,452,1961.2,1075.3,5327
375,EFIX,R,333819272,333819690,418,1374.0,722.6,5412
376,EFIX,R,333819041,333819216,175,1491.3,90.1,5196
377,EFIX,R,333818604,333818978,374,1262.2,729.1,5411
378,EFIX,R,333818242,333818576,334,1357.1,770.5,5377
379,EFIX,R,333817889,333818178,289,2247.7,536.0,4807
380,EFIX,R,333817411,333817823,412,2116.3,1310.5,4876
381,EFIX,R,333816678,333817283,605,1337.3,726.9,5020
382,EFIX,R,333816003,333816614,611,2344.9,731.3,4922
383,EFIX,R,333815239,333815951,712,2182.5,1031.3,5324
384,EFIX,R,333815123,333815217,94,2190.1,998.2,5577
385,EFIX,R,333813870,333813989,119,2363.8,2165.5,3777
386,EFIX,R,333813545,333813691,146,2158.8,1119.0,5040
387,EFIX,R,333812975,333813277,302,1287.2,724.7,5059
388,EFIX,R,333811880,333812932,1052,1274.7,1349.1,4301
389,EFIX,R,333811669,333811870,201,1273.0,1354.8,3870
390,EFIX,R,333811529,333811631,102,1012.0,1041.8,3909
391,EFIX,R,333811287,333811509,222,1023.0,999.8,3688
392,EFIX,R,333811158,333811259,101,969.8,889.6,3576
393,EFIX,R,333810850,333811127,277,1194.7,866.8,3643
394,EFIX,R,333810700,333810817,117,1401.5,1015.5,3645
395,EFIX,R,333810481,333810666,185,1310.2,987.9,3968
396,EFIX,R,333810233,333810428,195,760.9,284.3,4154
397,EFIX,R,333809927,333810192,265,491.3,228.6,4116
398,EFIX,R,333809717,333809883,166,601.6,612.9,3853
399,EFIX,R,333809528,333809691,163,625.3,532.7,4486
400,EFIX,R,333809211,333809470,259,527.2,1207.6,5493
401,EFIX,R,333808745,333809126,381,1276.6,724.6,5298
402,EFIX,R,333808455,333808727,272,1297.9,686.8,5323
403,EFIX,R,333808289,333808384,95,49.8,1107.0,5389
404,EFIX,R,333807712,333807962,250,1245.7,722.9,5297
405,EFIX,R,333807417,333807696,279,1274.3,710.0,5249
406,EFIX,R,333806537,333807410,873,1295.3,709.2,5365
407,EFIX,R,333805281,333806528,1247,1281.8,713.0,5334
408,EFIX,R,333804772,333805273,501,1297.0,716.0,5271
409,EFIX,R,333804530,333804754,224,1298.7,676.0,5323
410,EFIX,R,333803709,333804473,764,1375.5,-54.6,5038
411,EFIX,R,333802566,333803651,1085,470.6,-7.3,5286
412,EFIX,R,333802403,333802503,100,-98.6,713.0,5432
413,EFIX,R,333802112,333802342,230,-102.0,709.2,5421
414,EFIX,R,333801526,333802035,509,-87.0,710.9,5495
415,EFIX,R,333801211,333801513,302,-74.3,727.8,5485
416,EFIX,R,333800791,333801113,322,61.7,1279.3,5677
417,EFIX,R,333800683,333800780,97,53.0,1281.1,5615
418,EFIX,R,333800584,333800673,89,50.4,1275.2,5606
419,EFIX,R,333799796,333800418,622,207.4,1458.5,5367
420,EFIX,R,333799021,333799463,442,1255.0,720.8,5194
421,EFIX,R,333797742,333798964,1222,1960.2,582.8,4093
422,EFIX,R,333797502,333797733,231,1992.5,581.5,3261
423,EFIX,R,333797281,333797457,176,1390.5,864.3,3641
424,EFIX,R,333797061,333797252,191,1218.0,877.6,4169
425,EFIX,R,333796792,333797040,248,1189.7,858.7,4212
426,EFIX,R,333796626,333796749,123,581.8,618.9,3861
427,EFIX,R,333796460,333796609,149,540.0,625.4,4102
428,EFIX,R,333796186,333796412,226,1355.5,860.8,4118
429,EFIX,R,333795923,333796144,221,1257.1,1360.9,3605
430,EFIX,R,333795704,333795878,174,1184.0,879.9,3687
431,EFIX,R,333795534,333795673,139,1385.9,890.7,4253
432,EFIX,R,333794632,333795500,868,1279.8,714.9,5339
433,EFIX,R,333794370,333794618,248,1263.5,685.2,5252
434,EFIX,R,333793972,333794329,357,1533.4,1106.7,5181
435,EFIX,R,333793406,333793914,508,2225.0,487.4,4900
436,EFIX,R,333792860,333793183,323,1842.6,58.9,4895
437,EFIX,R,333792206,333792796,590,2315.5,507.0,4742
438,EFIX,R,333791775,333792138,363,2340.5,1365.2,4692
439,EFIX,R,333791109,333791721,612,2341.4,847.3,4627
440,EFIX,R,333790859,333791017,158,1522.7,671.6,5084
441,EFIX,R,333790593,333790799,206,995.6,198.1,5012
442,EFIX,R,333790451,333790527,76,237.4,818.3,5101
443,EFIX,R,333790301,333790325,24,236.4,841.9,4801
444,EFIX,R,333790034,333790250,216,232.5,846.9,4612
445,EFIX,R,333789516,333789960,444,642.5,770.8,3784
446,EFIX,R,333789087,333789210,123,-12.2,121.1,3433
447,EFIX,R,333788910,333789007,97,-173.9,615.1,3818
448,EFIX,R,333788702,333788867,165,-133.3,611.3,3941
449,EFIX,R,333788310,333788497,187,928.9,721.9,4928
450,EFIX,R,333787882,333788218,336,1972.2,282.6,4974
451,EFIX,R,333787516,333787801,285,1301.4,694.3,5458
452,EFIX,R,333787287,333787491,204,1339.2,703.7,5370
453,EFIX,R,333787180,333787219,39,3270.0,385.7,4806
454,EFIX,R,333786532,333786834,302,1291.1,708.9,5198
455,EFIX,R,333785264,333786477,1213,1951.3,574.9,4386
456,EFIX,R,333785115,333785247,132,1977.9,534.9,4234
457,EFIX,R,333784772,333785060,288,1256.0,1349.4,4216
458,EFIX,R,333784498,333784726,228,1238.3,1028.6,4353
459,EFIX,R,333784221,333784453,232,599.0,594.7,4036
460,EFIX,R,333784077,333784209,132,634.7,578.5,4913
461,EFIX,R,333783826,333784010,184,367.0,733.6,5424
462,EFIX,R,333783559,333783713,154,361.1,717.0,5607
463,EFIX,R,333783202,333783472,270,1286.3,678.3,5647
464,EFIX,R,333783006,333783176,170,1235.9,702.6,5666
465,EFIX,R,333782282,333782565,283,1675.2,2224.1,4391
466,EFIX,R,333782231,333782259,28,1645.6,2195.2,4452
467,EFIX,R,333781866,333782111,245,1319.8,710.8,5277
468,EFIX,R,333781231,333781809,578,1289.6,695.1,5303
469,EFIX,R,333781083,333781201,118,1199.7,829.7,4994
470,EFIX,R,333780014,333780187,173,1055.6,781.6,4546
471,EFIX,R,333779323,333779846,523,1029.7,768.1,4691
472,EFIX,R,333778986,333779298,312,1020.6,843.0,4673
473,EFIX,R,333778532,333778961,429,1067.7,786.7,4610
474,EFIX,R,333778259,333778479,220,1262.3,1401.7,4294
475,EFIX,R,333777988,333778196,208,952.2,622.4,4142
476,EFIX,R,333777681,333777951,270,1154.4,580.2,3952
477,EFIX,R,333777499,333777644,145,1524.8,633.7,4094
478,EFIX,R,333777155,333777470,315,1375.6,674.8,3966
479,EFIX,R,333776886,333777133,247,1416.8,623.5,3802
480,EFIX,R,333776584,333776851,267,1213.3,778.5,3921
481,EFIX,R,333776212,333776549,337,1389.6,658.8,4033
482,EFIX,R,333775960,333776179,219,1270.2,779.9,5198
483,EFIX,R,333775621,333775900,279,1084.3,1948.1,5224
484,EFIX,R,333775054,333775546,492,1713.2,1483.0,5268
485,EFIX,R,333774459,333775017,558,1831.0,1377.9,4928
486,EFIX,R,333774090,333774379,289,1264.3,706.5,4712
487,EFIX,R,333773828,333774067,239,1194.1,693.2,4446
488,EFIX,R,333773165,333773787,622,1312.0,631.4,4251
489,EFIX,R,333772788,333773108,320,1410.6,1324.1,4117
490,EFIX,R,333772423,333772728,305,1456.3,622.3,4550
491,EFIX,R,333772053,333772387,334,1535.9,787.6,4682
492,EFIX,R,333771783,333772038,255,1565.5,772.3,4436
493,EFIX,R,333771435,333771747,312,1420.7,635.6,4163
494,EFIX,R,333771087,333771402,315,1256.8,751.8,4164
495,EFIX,R,333770777,333771062,285,1311.1,749.9,4568
496,EFIX,R,333770602,333770746,144,1182.5,823.5,4505
497,EFIX,R,333770398,333770574,176,1293.3,745.2,4449
498,EFIX,R,333770044,333770369,325,1322.1,824.6,4298
499,EFIX,R,333769712,333770020,308,1328.8,737.6,4024
500,EFIX,R,333769150,333769687,537,1439.1,678.5,4310
501,EFIX,R,333767558,333769079,1521,2671.5,1057.0,4791
502,EFIX,R,333766888,333767521,633,2809.6,1166.8,4578
503,EFIX,R,333766114,333766850,736,2806.1,1398.8,4372
504,EFIX,R,333765814,333766079,265,2678.1,1434.3,4413
505,EFIX,R,333765187,333765783,596,2685.4,1595.2,4163
506,EFIX,R,333764557,333765154,597,2579.0,1311.2,4564
507,EFIX,R,333763461,333764514,1053,2632.0,918.1,4289
508,EFIX,R,333762806,333763383,577,2216.2,220.7,3836
509,EFIX,R,333762432,333762700,268,1067.1,638.3,4240
510,EFIX,R,333762194,333762393,199,1492.5,627.0,4020
511,EFIX,R,333762023,333762159,136,1251.6,700.1,4757
512,EFIX,R,333761819,333761960,141,289.3,114.1,5164
513,EFIX,R,333761469,333761703,234,864.1,484.5,5330
514,EFIX,R,333760551,333760738,187,1164.7,736.8,5258
515,EFIX,R,333760004,333760474,470,1291.7,722.7,4925
516,EFIX,R,333759670,333759970,300,1040.7,611.3,4831
517,EFIX,R,333759423,333759641,218,1221.7,609.9,4956
518,EFIX,R,333759192,333759392,200,1390.2,648.2,5032
519,EFIX,R,333758845,333759132,287,1572.0,1724.2,4532
520,EFIX,R,333758371,333758804,433,1647.1,1434.3,4319
521,EFIX,R,333757438,333758290,852,2296.5,730.4,4187
522,EFIX,R,333757057,333757333,276,1242.7,713.6,4490
523,EFIX,R,333756479,333756998,519,1215.2,598.4,4648
524,EFIX,R,333756257,333756454,197,1288.1,578.2,4602
525,EFIX,R,333755828,333756197,369,2355.9,969.0,3951
526,EFIX,R,333755361,333755625,264,1143.8,685.9,3364
527,EFIX,R,333755022,333755328,306,1214.9,575.2,3363
528,EFIX,R,333753774,333754993,1219,1282.7,715.4,5182
529,EFIX,R,333753586,333753729,143,1209.0,955.8,5249
530,EFIX,R,333753507,333753538,31,1281.5,712.5,5268
531,EFIX,R,333753065,333753460,395,1286.8,719.6,5242
532,EFIX,R,333752755,333753011,256,478.3,470.9,5043
533,EFIX,R,333752436,333752636,200,1283.7,709.1,5287
534,EFIX,R,333752182,333752418,236,1320.2,709.6,5231
535,EFIX,R,333752084,333752117,33,253.7,609.7,5264
536,EFIX,R,333751976,333752064,88,251.3,601.6,5416
537,EFIX,R,333751531,333751840,309,1266.3,699.0,5581
538,EFIX,R,333751377,333751505,128,1394.3,688.3,5661
539,EFIX,R,333750520,333750577,57,2355.3,1947.7,4011
540,EFIX,R,333750270,333750414,144,2354.7,1885.7,4089
541,EFIX,R,333749835,333750157,322,2198.3,554.9,4606
542,EFIX,R,333749201,333749583,382,1279.3,707.8,4930
543,EFIX,R,333748795,333749142,347,1943.7,569.7,4294
544,EFIX,R,333748477,333748747,270,1264.9,650.6,3926
545,EFIX,R,333748027,333748425,398,1131.8,1233.8,3831
546,EFIX,R,333747724,333747946,222,1752.9,139.7,4527
547,EFIX,R,333747463,333747689,226,2114.6,187.4,4576
548,EFIX,R,333746416,333747423,1007,1947.2,579.4,4432
549,EFIX,R,333745990,333746410,420,1970.8,589.6,3842
550,EFIX,R,333745760,333745947,187,1739.4,206.0,4044
551,EFIX,R,333745502,333745696,194,559.4,300.5,4237
552,EFIX,R,333745326,333745475,149,459.4,236.6,4090
553,EFIX,R,333745121,333745296,175,638.9,245.2,4093
554,EFIX,R,333744850,333745085,235,580.8,635.2,3931
555,EFIX,R,333744711,333744829,118,526.2,650.8,3875
556,EFIX,R,333744486,333744657,171,1449.4,912.5,3609
557,EFIX,R,333744237,333744447,210,1260.4,1395.4,3182
558,EFIX,R,333744015,333744194,179,1209.9,1022.7,3869
559,EFIX,R,333743709,333743979,270,1280.0,731.8,4980
560,EFIX,R,333743499,333743689,190,1278.8,702.2,4836
561,EFIX,R,333743271,333743440,169,1907.6,100.9,5003
562,EFIX,R,333742750,333743211,461,2363.7,507.5,4895
563,EFIX,R,333742315,333742721,406,2366.8,374.0,4773
564,EFIX,R,333741465,333742267,802,2315.2,755.2,5024
565,EFIX,R,333741070,333741402,332,2023.0,444.5,5227
566,EFIX,R,333740107,333741010,903,2403.0,931.4,4907
567,EFIX,R,333739033,333740076,1043,2422.1,694.2,4728
568,EFIX,R,333738966,333738997,31,2414.4,666.0,4768
569,EFIX,R,333738494,333738744,250,1417.1,77.2,5165
570,EFIX,R,333738109,333738413,304,366.2,348.5,5550
571,EFIX,R,333737873,333738014,141,255.1,1632.7,5239
572,EFIX,R,333737087,333737830,743,239.6,1631.6,5125
573,EFIX,R,333736372,333737066,694,219.3,1643.6,4722
574,EFIX,R,333735924,333736240,316,1274.0,676.4,4151
575,EFIX,R,333735566,333735873,307,1638.7,1483.8,4529
576,EFIX,R,333734792,333735032,240,1286.2,714.0,5372
577,EFIX,R,333734590,333734771,181,1221.4,693.7,5128
578,EFIX,R,333733311,333734544,1233,580.5,622.0,4624
579,EFIX,R,333732848,333733298,450,548.1,624.2,3558
580,EFIX,R,333732622,333732793,171,1462.4,988.2,3802
581,EFIX,R,333732445,333732589,144,1234.9,960.7,4173
582,EFIX,R,333732243,333732419,176,1332.0,968.6,4098
583,EFIX,R,333731820,333732197,377,1254.1,1383.1,3519
584,EFIX,R,333731588,333731780,192,1265.2,939.7,4168
585,EFIX,R,333731073,333731559,486,1276.5,727.5,5267
586,EFIX,R,333730362,333731061,699,1282.9,718.6,5287
587,EFIX,R,333730061,333730345,284,1293.7,704.9,5433
588,EFIX,R,333729821,333730040,219,1258.1,713.0,5443
589,EFIX,R,333729562,333729767,205,725.7,242.2,5254
590,EFIX,R,333729174,333729494,320,164.0,632.5,5380
591,EFIX,R,333728876,333729065,189,1244.6,708.2,5263
592,EFIX,R,333728454,333728861,407,1284.5,708.5,5379
593,EFIX,R,333728272,333728438,166,1301.9,689.3,5415
594,EFIX,R,333727966,333728217,251,1361.7,207.7,5330
595,EFIX,R,333727196,333727888,692,2330.0,486.6,4751
596,EFIX,R,333726855,333727128,273,2432.4,1163.6,4683
597,EFIX,R,333726337,333726578,241,1518.1,216.3,5139
598,EFIX,R,333724940,333726261,1321,2101.0,1203.6,5036
599,EFIX,R,333724693,333724865,172,1402.1,791.8,5335
600,EFIX,R,333724346,333724654,308,1282.8,680.2,5241
601,EFIX,R,333723950,333724289,339,1339.8,1491.0,5083
602,EFIX,R,333723609,333723883,274,1346.8,717.9,5094
603,EFIX,R,333723398,333723559,161,1017.9,1474.0,4856
604,EFIX,R,333722916,333723318,402,692.1,765.0,4744
605,EFIX,R,333722576,333722787,211,1896.9,140.6,4920
606,EFIX,R,333721992,333722366,374,1262.0,724.4,5288
607,EFIX,R,333721654,333721946,292,1281.8,1318.4,4844
608,EFIX,R,333720702,333721644,942,1264.5,1358.8,4107
609,EFIX,R,333720404,333720659,255,1239.7,1103.8,3976
610,EFIX,R,333720182,333720383,201,1291.9,1065.3,3807
611,EFIX,R,333719994,333720156,162,1243.8,968.9,3772
612,EFIX,R,333719912,333719955,43,1044.5,892.0,4009
613,EFIX,R,333719625,333719901,276,1066.4,880.6,4239
614,EFIX,R,333719469,333719604,135,1096.2,938.2,4380
615,EFIX,R,333719266,333719433,167,1376.5,997.6,4386
616,EFIX,R,333718964,333719222,258,1947.3,596.0,3799
617,EFIX,R,333718720,333718914,194,2183.0,252.8,3326
618,EFIX,R,333718471,333718695,224,2101.1,207.1,3294
619,EFIX,R,333718272,333718437,165,1828.0,121.8,3358
620,EFIX,R,333718047,333718261,214,1850.1,142.5,3385
621,EFIX,R,333717788,333718017,229,2031.0,188.3,3375
622,EFIX,R,333717562,333717758,196,1929.4,261.6,4405
623,EFIX,R,333716439,333717526,1087,2300.4,535.4,4883
624,EFIX,R,333715729,333716384,655,1992.9,877.9,5097
625,EFIX,R,333715127,333715647,520,1320.6,718.0,5400
626,EFIX,R,333714596,333715080,484,1667.9,348.8,5599
627,EFIX,R,333713550,333714505,955,2610.7,1407.7,4630
628,EFIX,R,333712472,333713488,1016,2420.1,670.2,4854
629,EFIX,R,333712137,333712371,234,1439.0,696.0,5588
630,EFIX,R,333711852,333712079,227,488.7,489.4,5661
631,EFIX,R,333711731,333711805,74,481.2,453.6,5801
632,EFIX,R,333711343,333711409,66,64.5,1637.6,5521
633,EFIX,R,333711207,333711259,52,61.3,1650.6,5375
634,EFIX,R,333711144,333711191,47,64.1,1649.2,5347
635,EFIX,R,333711088,333711112,24,69.3,1708.6,5114
636,EFIX,R,333710221,333710383,162,69.0,1264.7,5206
637,EFIX,R,333710180,333710211,31,67.5,1267.9,5203
638,EFIX,R,333710123,333710173,50,67.6,1264.8,5235
639,EFIX,R,333708985,333709635,650,1727.3,949.7,5178
640,EFIX,R,333708923,333708946,23,1724.4,944.7,5375
641,EFIX,R,333708858,333708900,42,1732.7,931.6,5359
642,EFIX,R,333708367,333708646,279,1258.4,706.0,4927
643,EFIX,R,333707830,333708323,493,587.3,596.9,4521
644,EFIX,R,333707104,333707822,718,596.8,616.6,4147
645,EFIX,R,333706976,333707076,100,779.0,573.9,5163
646,EFIX,R,333706680,333706945,265,688.2,519.1,5015
647,EFIX,R,333706408,333706620,212,1256.3,698.9,5091
648,EFIX,R,333705790,333706390,600,1293.5,711.9,5137
649,EFIX,R,333705535,333705766,231,1324.1,749.9,5147
650,EFIX,R,333705208,333705472,264,2345.1,456.6,4408
651,EFIX,R,333704521,333705132,611,2082.9,1228.3,4732
652,EFIX,R,333704170,333704433,263,1294.3,712.7,4977
653,EFIX,R,333703826,333704152,326,1307.3,748.3,4986
654,EFIX,R,333703552,333703759,207,389.8,1708.2,4629
655,EFIX,R,333703025,333703439,414,1341.9,1801.4,4099
656,EFIX,R,333702585,333702980,395,1481.4,1525.9,3514
657,EFIX,R,333702040,333702512,472,2175.7,1075.1,2515
658,EFIX,R,333701634,333701999,365,1925.8,1227.3,2761
659,EFIX,R,333701049,333701569,520,1169.2,1468.1,3153
660,EFIX,R,333700788,333700989,201,1401.7,782.0,4487
661,EFIX,R,333700562,333700764,202,1348.5,795.4,4713
662,EFIX,R,333700210,333700542,332,1316.1,839.3,4482
663,EFIX,R,333700042,333700156,114,1328.1,1526.0,4035
664,EFIX,R,333699760,333699988,228,1457.9,888.1,4025
665,EFIX,R,333699332,333699731,399,1552.4,825.7,3644
666,EFIX,R,333699102,333699285,183,1450.6,641.7,3693
667,EFIX,R,333699038,333699071,33,1263.4,689.8,4698
668,EFIX,R,333698761,333699016,255,1306.4,705.2,4938
669,EFIX,R,333698485,333698704,219,400.8,482.0,4649
670,EFIX,R,333698425,333698469,44,390.7,435.6,4890
671,EFIX,R,333697941,333698325,384,1278.0,710.1,4716
672,EFIX,R,333697588,333697726,138,2111.6,24.1,3860
673,EFIX,R,333697077,333697288,211,1269.6,724.3,4223
674,EFIX,R,333696839,333697043,204,1033.8,590.2,4155
675,EFIX,R,333696575,333696817,242,981.6,620.1,4062
676,EFIX,R,333694817,333696559,1742,1030.5,596.3,3836
677,EFIX,R,333693945,333694792,847,1099.1,685.6,3944
678,EFIX,R,333693540,333693930,390,1134.4,702.0,4285
679,EFIX,R,333693068,333693509,441,1032.1,620.5,3849
680,EFIX,R,333692849,333693040,191,1097.6,708.7,4060
681,EFIX,R,333692542,333692836,294,1117.9,708.5,4080
682,EFIX,R,333692371,333692516,145,1027.0,629.7,4068
683,EFIX,R,333692165,333692341,176,1219.6,605.2,4187
684,EFIX,R,333692019,333692140,121,1256.6,651.1,4746
685,EFIX,R,333691796,333691974,178,1870.5,349.8,4999
686,EFIX,R,333690492,333691748,1256,2329.2,667.1,4494
687,EFIX,R,333690015,333690277,262,1285.0,687.3,4035
688,EFIX,R,333689727,333689984,257,1398.2,615.8,3806
689,EFIX,R,333689193,333689700,507,1454.7,609.2,3841
690,EFIX,R,333688837,333689175,338,1420.8,640.2,4111
691,EFIX,R,333687832,333688823,991,1458.3,615.9,4250
692,EFIX,R,333686367,333687822,1455,1459.3,603.1,3936
693,EFIX,R,333686189,333686341,152,1356.1,616.9,2876
694,EFIX,R,333685886,333686136,250,1002.7,1431.4,3332
695,EFIX,R,333685670,333685823,153,1557.1,722.6,3847
696,EFIX,R,333685345,333685642,297,1448.1,635.7,3754
697,EFIX,R,333685173,333685324,151,1498.3,642.3,3921
698,EFIX,R,333684966,333685139,173,1121.1,689.6,4711
699,EFIX,R,333684738,333684923,185,548.5,465.8,5180
700,EFIX,R,333684362,333684657,295,1281.8,717.7,5201
701,EFIX,R,333684175,333684336,161,1232.2,623.6,5316
702,EFIX,R,333683675,333684097,422,-66.1,1523.5,4868
703,EFIX,R,333683180,333683368,188,1271.7,708.2,5244
704,EFIX,R,333683003,333683162,159,1271.5,662.4,5165
705,EFIX,R,333682734,333682950,216,1902.3,1454.0,4767
706,EFIX,R,333682417,333682671,254,2449.5,915.0,4389
707,EFIX,R,333681753,333682358,605,2243.9,291.8,4213
708,EFIX,R,333681052,333681662,610,1199.5,285.9,4302
709,EFIX,R,333680588,333680993,405,937.0,825.9,4134
710,EFIX,R,333680165,333680561,396,1065.7,783.5,4304
711,EFIX,R,333679998,333680127,129,967.2,637.9,4227
712,EFIX,R,333679780,333679964,184,1095.6,807.0,4266
713,EFIX,R,333679412,333679749,337,1248.9,841.0,4115
714,EFIX,R,333679130,333679389,259,1230.3,777.3,4198
715,EFIX,R,333678897,333679097,200,1442.7,633.8,4546
716,EFIX,R,333678608,333678876,268,1423.4,691.0,4407
717,EFIX,R,333678164,333678537,373,2390.8,2020.3,2655
718,EFIX,R,333678071,333678115,44,2423.0,1975.6,2881
719,EFIX,R,333677579,333677952,373,1289.8,709.3,4964
720,EFIX,R,333676915,333677572,657,1286.2,703.1,5409
721,EFIX,R,333676750,333676896,146,1340.9,660.7,5452
722,EFIX,R,333676463,333676684,221,1025.2,2176.9,4740
723,EFIX,R,333676096,333676416,320,1269.1,2121.8,4735
724,EFIX,R,333675938,333675981,43,1256.0,684.6,5215
725,EFIX,R,333675766,333675888,122,1257.6,684.2,5135
726,EFIX,R,333675351,333675578,227,1719.0,2143.6,4168
727,EFIX,R,333675193,333675302,109,1695.6,2148.4,4137
728,EFIX,R,333674879,333675057,178,1268.9,715.5,4468
729,EFIX,R,333674701,333674849,148,1326.4,796.6,4056
730,EFIX,R,333674434,333674627,193,1743.5,315.1,4477
731,EFIX,R,333674161,333674372,211,2182.3,555.9,4508
732,EFIX,R,333673601,333673920,319,1277.9,727.7,4678
733,EFIX,R,333673415,333673575,160,1207.4,702.0,4290
734,EFIX,R,333673246,333673361,115,1838.9,116.4,3687
735,EFIX,R,333673001,333673210,209,2155.6,179.1,3680
736,EFIX,R,333672732,333672977,245,2058.5,200.3,3839
737,EFIX,R,333672453,333672690,237,1820.9,284.6,4557
738,EFIX,R,333672250,333672424,174,1697.3,281.6,4913
739,EFIX,R,333672035,333672215,180,1529.5,330.4,4995
740,EFIX,R,333671753,333671964,211,1339.4,1376.2,4957
741,EFIX,R,333671508,333671680,172,1952.1,598.8,4650
742,EFIX,R,333670302,333671498,1196,1953.6,581.1,4082
743,EFIX,R,333670161,333670291,130,1940.1,587.7,3645
744,EFIX,R,333669793,333670127,334,1808.1,270.1,3650
745,EFIX,R,333669367,333669728,361,357.3,230.2,3557
746,EFIX,R,333669084,333669332,248,631.5,332.6,3689
747,EFIX,R,333668843,333669061,218,637.4,218.1,3686
748,EFIX,R,333668576,333668829,253,667.8,232.7,3578
749,EFIX,R,333668186,333668539,353,551.0,602.1,3152
750,EFIX,R,333667898,333668138,240,1074.9,899.2,3279
751,EFIX,R,333667636,333667875,239,1032.1,953.0,3524
752,EFIX,R,333667434,333667608,174,1101.3,1042.7,3723
753,EFIX,R,333667118,333667403,285,949.3,1136.1,3501
754,EFIX,R,333666896,333667088,192,1080.0,1069.0,3476
755,EFIX,R,333666714,333666864,150,1167.8,890.8,3241
756,EFIX,R,333666453,333666684,231,1368.3,794.4,3240
757,EFIX,R,333666225,333666419,194,1514.5,1065.8,3240
758,EFIX,R,333665989,333666199,210,1512.4,928.9,3193
759,EFIX,R,333665760,333665967,207,1430.8,972.7,3152
760,EFIX,R,333665600,333665732,132,1277.6,952.8,3439
761,EFIX,R,333665309,333665575,266,1209.3,985.3,3997
762,EFIX,R,333665038,333665282,244,1115.1,967.9,4668
763,EFIX,R,333664693,333664991,298,1268.5,1355.8,4287
764,EFIX,R,333664386,333664638,252,1976.2,589.4,3743
765,EFIX,R,333664235,333664357,122,1925.8,411.8,4516
766,EFIX,R,333664117,333664191,74,2538.3,754.4,4749
767,EFIX,R,333663418,333664076,658,2259.8,551.1,4992
768,EFIX,R,333662897,333663389,492,2258.9,419.2,4912
769,EFIX,R,333662345,333662837,492,2403.1,977.2,4973
770,EFIX,R,333661852,333662135,283,1318.8,704.6,5434
771,EFIX,R,333661323,333661840,517,1286.7,722.2,5393
772,EFIX,R,333659997,333661312,1315,1296.6,712.1,5368
773,EFIX,R,333659786,333659975,189,1284.4,676.1,5414
774,EFIX,R,333659426,333659748,322,1093.7,198.6,5343
775,EFIX,R,333658662,333659339,677,2256.4,108.6,4610
776,EFIX,R,333657998,333658603,605,2608.3,750.0,4512
777,EFIX,R,333657345,333657941,596,2548.6,1218.6,4538
778,EFIX,R,333656767,333657281,514,2175.4,1787.9,4272
779,EFIX,R,333656338,333656650,312,1288.1,710.0,4446
780,EFIX,R,333656108,333656315,207,1321.6,657.7,3863
781,EFIX,R,333655882,333656052,170,1015.2,175.8,4446
782,EFIX,R,333655478,333655808,330,774.1,685.0,4896
783,EFIX,R,333655344,333655368,24,1995.4,32.3,4790
784,EFIX,R,333655238,333655291,53,1996.7,26.7,4806
785,EFIX,R,333654315,333654694,379,1297.7,709.7,5274
786,EFIX,R,333653190,333654273,1083,1277.1,1337.4,4686
787,EFIX,R,333653012,333653172,160,1267.1,1387.8,3614
788,EFIX,R,333652893,333652979,86,1023.1,1253.8,3447
789,EFIX,R,333652692,333652830,138,753.8,244.1,4031
790,EFIX,R,333652179,333652645,466,1306.8,681.8,5432
791,EFIX,R,333651097,333651364,267,1280.6,721.5,5175
792,EFIX,R,333650914,333651068,154,1181.1,727.5,5444
793,EFIX,R,333650334,333650837,503,2357.7,650.9,4802
794,EFIX,R,333649858,333650260,402,1883.1,664.9,5084
795,EFIX,R,333648963,333649275,312,1279.8,715.0,5428
796,EFIX,R,333647876,333648920,1044,1286.0,1323.4,5296
797,EFIX,R,333647585,333647868,283,1291.3,1341.0,5332
798,EFIX,R,333647375,333647549,174,1399.0,1054.3,5352
799,EFIX,R,333647128,333647347,219,1359.8,945.7,5263
800,EFIX,R,333646247,333647087,840,1283.2,1334.2,4729
801,EFIX,R,333645972,333646237,265,1268.6,1381.6,4005
802,EFIX,R,333645693,333645961,268,1270.7,1369.6,3514
803,EFIX,R,333645508,333645655,147,1368.4,948.5,4134
804,EFIX,R,333644949,333645477,528,1280.8,711.3,5195
805,EFIX,R,333644584,333644933,349,1282.6,692.9,5293
806,EFIX,R,333644386,333644573,187,1267.2,726.1,5403
807,EFIX,R,333643949,333644320,371,177.7,584.6,5391
808,EFIX,R,333643384,333643817,433,1265.2,722.1,5139
809,EFIX,R,333643096,333643378,282,1277.5,712.0,5264
810,EFIX,R,333642935,333643074,139,1323.8,670.4,5595
811,EFIX,R,333642091,333642780,689,2756.0,1472.7,4508
812,EFIX,R,333641633,333642063,430,2662.8,1301.1,4678
813,EFIX,R,333641247,333641589,342,2577.8,930.3,4846
814,EFIX,R,333639574,333641216,1642,2638.7,702.4,4635
815,EFIX,R,333639229,333639514,285,2679.9,1281.0,4427
816,EFIX,R,333638861,333639181,320,2541.1,1082.0,4643
817,EFIX,R,333638458,333638800,342,2329.7,576.4,4768
818,EFIX,R,333637780,333638415,635,2293.3,337.6,4532
819,EFIX,R,333637355,333637573,218,1525.9,3.7,4963
820,EFIX,R,333636872,333637277,405,2298.5,732.0,4750
821,EFIX,R,333636683,333636809,126,2068.4,1693.1,4448
822,EFIX,R,333636445,333636675,230,2060.2,1736.7,4403
823,EFIX,R,333635809,333636109,300,1272.1,724.8,4957
824,EFIX,R,333634565,333635762,1197,588.9,619.5,4317
825,EFIX,R,333634442,333634522,80,585.1,295.2,4629
826,EFIX,R,333633942,333634387,445,177.2,717.7,4980
827,EFIX,R,333633508,333633743,235,1269.1,711.2,4748
828,EFIX,R,333633271,333633500,229,1286.0,710.8,4852
829,EFIX,R,333632939,333633254,315,1331.8,731.5,4756
830,EFIX,R,333631393,333632775,1382,1269.2,707.2,4255
831,EFIX,R,333631233,333631366,133,1133.3,683.1,3176
832,EFIX,R,333630943,333631216,273,1168.4,715.3,3207
833,EFIX,R,333630673,333630917,244,1263.5,776.8,3402
834,EFIX,R,333630167,333630648,481,1182.5,801.2,4022
835,EFIX,R,333629913,333630150,237,1146.9,809.5,4396
836,EFIX,R,333629605,333629879,274,961.0,680.0,4186
837,EFIX,R,333629369,333629583,214,962.0,637.7,3915
838,EFIX,R,333629195,333629338,143,985.6,834.5,3843
839,EFIX,R,333628946,333629165,219,1114.4,859.3,3774
840,EFIX,R,333628683,333628912,229,1325.6,851.2,3566
841,EFIX,R,333628402,333628650,248,1447.6,775.2,3332
842,EFIX,R,333628151,333628380,229,1432.5,709.7,3265
843,EFIX,R,333627911,333628129,218,1489.0,677.2,3212
844,EFIX,R,333627647,333627886,239,1526.2,629.0,3136
845,EFIX,R,333627432,333627620,188,1393.3,635.3,3148
846,EFIX,R,333627093,333627400,307,1161.5,740.1,3428
847,EFIX,R,333626886,333627070,184,1117.4,743.2,3775
848,EFIX,R,333626658,333626861,203,1133.2,796.8,4287
849,EFIX,R,333626462,333626634,172,1241.9,760.5,4482
850,EFIX,R,333626260,333626436,176,1277.4,667.5,5598
851,EFIX,R,333625916,333626188,272,2579.9,1797.1,4224
852,EFIX,R,333624819,333624962,143,2463.4,1132.3,4209
853,EFIX,R,333624377,333624597,220,1271.6,729.0,4518
854,EFIX,R,333624014,333624353,339,1339.3,742.5,4325
855,EFIX,R,333623704,333623982,278,1440.4,635.8,4147
856,EFIX,R,333623458,333623670,212,1540.2,829.0,4018
857,EFIX,R,333623195,333623442,247,1576.4,809.2,3857
858,EFIX,R,333622928,333623157,229,1263.2,624.6,3740
859,EFIX,R,333622760,333622907,147,1224.5,664.2,3771
860,EFIX,R,333622501,333622737,236,1163.2,731.0,3811
861,EFIX,R,333622140,333622479,339,1195.3,689.5,3932
862,EFIX,R,333621818,333622116,298,1256.6,640.2,4321
863,EFIX,R,333621655,333621783,128,1100.4,763.0,4439
864,EFIX,R,333621384,333621624,240,1028.6,824.4,4169
865,EFIX,R,333620541,333621354,813,1023.1,675.5,3931
866,EFIX,R,333620300,333620510,210,1170.7,690.4,4022
867,EFIX,R,333620058,333620273,215,1193.4,813.6,3909
868,EFIX,R,333619809,333620029,220,1336.4,781.2,3735
869,EFIX,R,333619571,333619773,202,1428.9,627.1,3607
870,EFIX,R,333619345,333619553,208,1414.6,660.3,3990
871,EFIX,R,333618850,333619315,465,1266.3,717.4,5123
872,EFIX,R,333618635,333618833,198,1286.2,707.0,5056
873,EFIX,R,333618579,333618602,23,1209.3,697.1,5029
874,EFIX,R,333617982,333618547,565,1251.7,713.8,5020
875,EFIX,R,333617719,333617973,254,1279.5,707.8,5087
876,EFIX,R,333617565,333617708,143,1249.1,685.9,5152
877,EFIX,R,333616772,333617505,733,2385.1,728.6,4348
878,EFIX,R,333615937,333616573,636,1467.1,626.1,4571
879,EFIX,R,333615709,333615900,191,1098.4,642.1,4591
880,EFIX,R,333615471,333615657,186,1200.0,1469.7,4409
881,EFIX,R,333615185,333615401,216,1510.6,597.8,4274
882,EFIX,R,333614704,333615166,462,1458.2,602.5,4238
883,EFIX,R,333614408,333614688,280,1447.1,636.5,4247
884,EFIX,R,333614192,333614379,187,1569.7,699.8,3866
885,EFIX,R,333613613,333614164,551,1451.5,616.8,3947
886,EFIX,R,333613427,333613596,169,1418.9,621.9,4050
887,EFIX,R,333613176,333613388,212,942.5,737.8,3840
888,EFIX,R,333613007,333613151,144,935.8,632.7,3610
889,EFIX,R,333612507,333612981,474,1053.2,640.2,3591
890,EFIX,R,333612294,333612473,179,1459.0,656.5,3989
891,EFIX,R,333612128,333612262,134,1301.4,716.2,5234
892,EFIX,R,333611925,333612116,191,1334.2,716.5,5187
893,EFIX,R,333611742,333611868,126,364.7,657.9,5073
894,EFIX,R,333611628,333611664,36,996.5,686.9,5065
895,EFIX,R,333610465,333611553,1088,1262.9,720.3,4553
896,EFIX,R,333610211,333610458,247,1247.6,719.8,3931
897,EFIX,R,333609983,333610175,192,1527.3,574.0,3338
898,EFIX,R,333609734,333609919,185,1259.5,1491.2,4024
899,EFIX,R,333609501,333609676,175,942.3,780.6,4024
900,EFIX,R,333609147,333609463,316,1038.5,623.1,4149
901,EFIX,R,333608733,333609136,403,1017.7,625.3,4088
902,EFIX,R,333608093,333608702,609,1200.3,596.5,4332
903,EFIX,R,333607607,333608058,451,1581.4,543.7,3999
904,EFIX,R,333607344,333607574,230,1548.0,713.3,4219
905,EFIX,R,333607133,333607317,184,1572.5,596.8,4400
906,EFIX,R,333606997,333607092,95,1201.9,593.8,4369
907,EFIX,R,333606767,333606963,196,1568.3,575.7,4153
908,EFIX,R,333606480,333606734,254,1500.5,813.9,4129
909,EFIX,R,333606261,333606444,183,1112.7,698.1,3926
910,EFIX,R,333605981,333606231,250,1217.5,617.3,3873
911,EFIX,R,333605717,333605950,233,1058.0,661.3,3866
912,EFIX,R,333605456,333605696,240,1001.5,612.5,3556
913,EFIX,R,333605226,333605425,199,1230.8,593.5,4164
914,EFIX,R,333604149,333605196,1047,1266.0,715.0,5095
915,EFIX,R,333603981,333604134,153,1233.3,707.6,4386
916,EFIX,R,333603647,333603951,304,1136.7,498.4,4019
917,EFIX,R,333603564,333603615,51,1151.7,728.3,4125
